000001000000000
000001000000000
000001000000000
000000000000000
000000000000000
000000000000111
000000000000000
000100000000000
000000001000000
000000000100000
000000000000000
000000000000000
000000000000000
111111000001000
000000000000000
000000000000000
000000000000000
000000000100000
000000000100000
000000000100000
